111111111111111
100000000000111
1000CPE00000011
111100000111101
100000100000111
100000000000011
100000111111111
100000000000011
100000111111111
100000000000011
111111111111111
