111111111111
1111000CEP11
111111111111