111111111111
10000P00CC01
1E1000000001
11111000CC01
1100C1111001
1C0000000001
111111111111