111111111111111
1C0E00CCC000111
10000P000000011
111100000111101
100000100000111
100000000000011
100000111111111
100000000000011
100000111111111
100000000000011
111111111111111
