111111111111111
1CPE00000000111
111111111111111
111111111111111
