111111111111
1000CP000001
1E000000C001
111111111111