111111111111111
1CPE00CCC000111
100000000000011
111111111111111
