111111111111
1111000CEP11
1111111111111