111111111111
10000P00CC01
1E0000000001
11111000CC01
1000C1111001
100000000001
111111111111