111111111111111
100000000000111
10000P0E0000011
111100000111101
100000100000111
100000000000011
10C000111111111
100000000000011
10C000111111111
10000C000C00011
111111111111111
