111111
100001
1C0011
1PK0E1
111111