111111111111111
100001000000111
10001P0E0000011
111101000111101
1000001K0000111
100000000000011
10C000111111111
100K0000K000011
10C000111111111
10000C000C00011
111111111111111
