1111111111111111111
1P00000000000000001
111111110000K011111
1000KC00C000000E001
1111111111111111111
